 =login.jsp
loginPage=login.jsp
registerPage=register.jsp
login=loginServlet
register=RegisterServlet
logout=logOutServlet
homePage=home.jsp
loadCarDefault=loadCarDefaultServlet
loadListBySearch=loadListBySearchServlet
searchByName=searchByNameServlet
searchByCategory=searchByCategoryServlet
addToCart=addToCartServlet
checkDateValidOrder=checkDateValidOrderServlet
checkDateRentPossible=checkDateRentPossibleServlet
checkDateRent=checkDateRentServlet
updateCarCart=updateCarCartServlet
removeCarCart=removeCarCartServlet
proceedToRenting=proceedToRentingServlet
viewcartPage=viewcart.jsp
failVerifyPage=failVerify.jsp
VerifyPage=Verify.jsp
VerifyCode=VerifyCodeServlet
applyDiscount=applyDiscountServlet
loadOrder=loadOrderServlet
loadOrderByDate=loadOrderByDateServlet
loadOrderDetail=loadOrderDetailServlet
historyOrderPage=historyOrder.jsp
historyOrderDetailPage=historyOrderDetail.jsp
deleteOrder=deleteOrderServlet
feedbackDetail=feedbackDetailServlet